身体 (shēn tǐ) - body
皮肤 (pí fū) - skin
肌肉 (jī ròu) - muscle
毛 (máo) - (body) hair
骨头 (gǔ tou) - bone   
关节 (guān jié) - joints  
头 (tóu) - head 
头发 (tóu fa) - hair (on head)
大脑 (dà nǎo) - brain
脸 (liǎn) - face
额头 (é tóu) - forehead
眼睛 (yǎn jing) - eye
眼皮 (yǎn pí) - eyelid
眉毛 (méi mao) - eyebrow
睫毛 (jié máo) - eyelash(es)
鼻子 (bí zi) - nose
脸颊 (liǎn jiá) - cheek
耳朵 (ěr duo) - ear
嘴 (zuǐ) - mouth
嘴唇 (zuǐ chún) - lip
牙齿 (yá chǐ) - tooth
舌头 (shé tou) - tongue
喉咙 (hóu long) - throat
心脏 (xīn zàng) - heart
肝 (gān) - liver
肺 (fèi) - lung
胃 (wèi) - stomach
大肠 (dà cháng) - large intestine
小肠 (xiǎo cháng) - small intestine 
脖子 (bó zi) - neck
背 (bèi) - back
胸 (xiōng) - chest
肚子 (dù zi) - abdomen, belly
肩膀 (jiān bǎng) - shoulder
胳膊 (gē bo) - arm
胳膊肘 (gē bo zhǒu) - elbow
手 (shǒu) - hand
指关节 (zhǐ guān jié) - knuckle
手指 (shǒu zhǐ) - finger
指甲 (zhǐ jia) - fingernail
臀部 (tún bù) - buttocks
屁股 (pì gu) - buttocks
腿 (tuǐ) - leg
膝盖 (xī gài) - knee
脚 (jiǎo) - foot/feet
脚脖子 (jiǎo bó zi) - ankle
脚趾 (jiǎo zhǐ) - toe
脚趾甲 (jiǎo zhǐ jiǎ) - toenail
